NO IMG/Wolfenstein/bluestone.png
SO IMG/Wolfenstein/greystone.png
WE IMG/Wolfenstein/wood.png
EA IMG/Wolfenstein/redbrick.png

F 220,100,0
C 225,30,0

111111111111111111111111111
100000000000000011111111111
10000000111000001
10000011011000001
1000011001100001
10001111111110001
100000000110000011111
1000000001100001111111
100000000000000000000011
111111111111111111111111111