NO IMG/Wolfenstein/bluestone.png
SO IMG/Wolfenstein/greystone.png
WE IMG/Wolfenstein/wood.png
EA IMG/Wolfenstein/redbrick.png

F 220,100,0
C 225,30,0

111111111111111111111111111111
1S0000000000000011111111111
100000001110000000000000111
1000001101100000000000001111
1000011001100000000000000001
10001111111110000000000000001
100000000110000011100111111111
100000000110000111100111111
100000000000000000000011
100000000000000000000011
100000000000000000000011
111111111111111111111111111