NO textures/eagle.xpm
SO textures/greystone.xpm
WE textures/purplestone.xpm
EA textures/red.xpm
F 100,100,0
C 000,30,0

11111111111111
1000000001S101
1000V000000001
100V000V01P101
100000V0010101
1000000001P101
10000001010101
1000000001P101
1001P1P1010101
10000000000001
10000000000101
11111111111111