NO textures/eagle.xpm
SO textures/greystone.xpm
WE textures/purplestone.xpm
EA textures/red.xpm
F 100,100,0
C 000,30,0

11111111111111
10000000010101
100000N00P0P01
10000000010101
11111111111111