NO textures/eagle.xpm
SO textures/greystone.xpm
WE textures/purplestone.xpm
EA textures/red.xpm
F 100,100,0
C 000,30,0

11111111111111
10000000010101
1000V000000001
100V000V010101
100000V0010101
1000V000010101
10000000010101
1001P10V010101
10000000010101
1010N000000001
1000VV00000101
11111111111111