NO IMG/Wolfenstein/bluestone.png
SO IMG/Wolfenstein/greystone.png
WE IMG/Wolfenstein/wood.png
EA IMG/Wolfenstein/redbrick.png

F 128,128,128
C 0,0,0

11111111111111
100000W0000001
10000000000001
10000000000001
10000000000001
10000000000001
10000000000001
10000000000001
10000000000001
10000000000001
10000000000001
10000000000001
10000000000001
11111111111111