NO textures/eagle.xpm
SO textures/greystone.xpm
WE textures/purplestone.xpm
EA textures/red.xpm
F 100,100,0
C 000,30,0

11111111111111
10000000000001
10000000000001
10000000000001
10001000000001
1000P010000001
100010P0W10001
100010100P0001
10000010010001
100000P00P0001
10000010010001
10000000000001
10000001010101
10000000000001
11111111111111