NO IMG/Wolfenstein/bluestone.png   
SO IMG/Wolfenstein/greystone.png 
WE IMG/Wolfenstein/wood.png
EA IMG/Wolfenstein/redbrick.png

F 220,100,0
C 225,30,0

11111111111111
100001N1000001
10000101000001
10000000000001
10000000000001
10000000000001
10000000000001
10000000000001
10000000000001
10000000000001
10000000000001
10000000000001
10000000000001
11111111111111