NO textures/eagle.xpm
SO textures/greystone.xpm
WE textures/purplestone.xpm
EA textures/red.xpm
F 100,100,0
C 000,30,0

11111111111111
10000000000001
10000000000001
100000000000011111111111111111111111111111111111111111111111111111111111111111111111111111111111111111111111111111111111111111111111111
100000000000000000000000000000000000000000000000000000000000000000000000000000000000000000000000000000000000000000000000000000000000001
100000000000011111111111111111111111111111111111111111111111111111111111111111111111111111111111111111111111111111111111111111111111111
10000000000001
10000000000001
10000100000001
10000P00000001
10000100N00001
10000000000001
10000000000001
10000000000001
11111111111111