NO textures/eagle.xpm
SO textures/greystone.xpm
WE textures/purplestone.xpm
EA textures/red.xpm
F 100,100,0
C 000,30,0

11111111111111
10000000010101
100000000P0P01
10000000010101
10000000010101
10000000010101
10000000010101
10000000010101
1000N000010101
101P1000000001
10000000000101
11111111111111