NO IMG/Wolfenstein/bluestone.png
SO IMG/Wolfenstein/greystone.png
WE IMG/Wolfenstein/wood.png
EA IMG/Wolfenstein/redbrick.png

F 220,100,0
C 225,30,0

        1111111111111111111111111
        1000000000110000000000001
        1011000001110000000000001
        1001000000P00000000000001
111111111011000001110000000000001
10000000001100000111011111P111111
11110111111111011100000010001
11110111111111011101010010001
110000001101010000000000P0001
1000000000000E001100000010001
1000000000000000P001010010001
1100000111010101111101111000111
11110111 1110101 101111010001
11111111 1111111 111111111111