NO ./path_to_the_north_texture
SO ./path_to_the_south_texture
WE ./path_to_the_west_texture
C 225,30,0
EA ./path_to_the_east_texture

            F               250,100,0

             1111111111111111111111111
             1000000000110000000000001
             1011000001110000000000001
             1001000000000000000000001
11111111111111011000001110000000000001
10000000001100000111011111111111111111
111101111111110111000000100011111
111101111111110111010100100011111                 
110000001101010111000000100011111
100000000000000011000000100011111               
100000000000000011010110100011111                          
11000001100101011111011110N011111             
1111011111101011101111010001111111
11111111 111111111111111111111111