NO ./path_to_the_north_texture
SO ./path_to_the_south_texture
WE ./path_to_the_west_texture
C 225,30,0
EA ./path_to_the_east_texture

            F                250, 100,0

//todo verifier que les 0 ne sont pas entoure despace
//todo remplacer les espaces par des 1
        111111111111111111111111
       01000000000110000000000001
        1011000001110000000000001
        1001000000000000000000001
111111111011000001110000000000001                    1
100000000011000001110111111111111                   101
111101111111110111000000100011111                    1
111101111111110111010100100011111
110000001101010111000000100011111
100000000000000011000000100011111
100000000000000011010100100011111
11000001110101011111011110N011111
11110111 111010111011110100011111
11111111 111111111111111111111111