NO textures/matrix.xpm
SO textures/matrix.xpm
WE textures/matrix.xpm
EA textures/matrix.xpm
C 0,0,0

F 0,0,0

        1111111111111111111111111
        100000P000110000000000001
        1011001010010000000000001
        100P00P000VPV000001P100V1
111111111011001010010000000000001
100000000011000001010111110111111
11110111111111V1110000V010001
1111011111111101111P10V010001
110000001101V10000000VVWVVVV1
111101111111110111100VV010001
1111V111111111P111101VV010001
11000V001101010000000VV000001
10000V000000000011110VV010001
1000000000000000P0P00VV010001
1100000111010101111101111000111
110000001101V1000000000000001
11110111111111011110000010001
1111V111111111P11110100010001
11000V00110101000000000000001
10000V00000000001111000010001
1000000000000000P0P0V00010001
1100000111010101111101111000111
11110111 1110101 101111010001
11111111 1111111 111111111111