NO textures/eagle.xpm
SO textures/greystone.xpm
WE textures/purplestone.xpm
EA textures/red.xpm

C 70,70,70

F 100,100,111

        1111111111111111111111111
        1000000000110000000000001
        1011000000010000000000001
        1001000000VPVW000000000V1
111111111011000000010000000000001
100000000011000001010111110111111
11110111111111V11100000010001
11110111111111011110100010001
110000001101V1000000000000001
11110111111111011110000010001
1111V111111111011110100010001
11000V00110101000000000000001
10000V00000000001111000010001
1000000000000000P0P0V00010001
1100000111010101111101111000111
11110111 1110101 101111010001
11111111 1111111 111111111111