NO IMG/Wolfenstein/bluestone.png
SO IMG/Wolfenstein/greystone.png
WE IMG/Wolfenstein/wood.png
EA IMG/Wolfenstein/redbrick.png

F 220,100,0
C 225,-0,0

11111            111   
10001        111  10111
10101        1011111011
10001       111110000011
11111     1111111111111111